1111111111111
1000000000001
11000P0000011
100000000E001
1000000000011
11E0111000011
1CCCCCCC00001
1111111111111
