11111111111111111111111111111111111111111
10P00000000000000000000000000000000000001
1000000000E000000000000000000000000000001
10000000000000000000000000000000000000001
10101010101010101010101010000000001111111
10000000000000000000001011111111111111111
10000000000000000000001011111111111111111
10000000000000000000001011111111111111111
11111111111111111111111111111111111111111